111111111111111111111
1.............1.....1
1.............1.....1
1...1...............1
1........1....1.....1
1........P....111.111
1....1..............1
1.............111.111
1.............1.1.1..
11.11.........1.1.1..
1i..1.........111.1..
1...1.............1..
1...1.........11111..
111111111111111......