111111111111111111111
1.............1.....1
1.............1.....1
1...1...............1
1........1....1.....1
1........P....111.111
1....1..............1
1.............111.111
111.11........1.1.1..
1i...1........1.1.1..
1.............111.1..
1i...1............1..
1.i.i1........11111..
111111111111111......